29
15
26 25 25 26 25 25 25 26 25 25 26 26 26 25 25 25 25 25 26 25 26 26 25 25 25 26 26 25 26 
26 16 18 25 26 16 14 14 14 14 14 14 14 14 14 14 14 14 14 15 25 16 14 14 14 14 14 14 14 
25 2 0 15 25 2 0 0 0 0 0 0 0 0 0 0 0 0 0 1 25 2 0 0 0 0 0 0 0 
25 25 25 7 25 2 0 0 0 0 0 0 0 0 0 0 0 4 26 7 26 2 0 0 0 0 0 0 0 
26 25 26 3 26 10 0 0 0 0 50 52 0 0 0 0 0 1 25 3 26 2 0 0 0 0 0 0 0 
25 25 25 3 30 52 0 0 0 0 0 0 0 0 0 4 32 7 25 12 25 2 0 0 0 0 0 0 0 
25 26 26 11 25 10 0 0 0 50 31 51 52 0 0 9 31 2 14 1 25 10 0 0 0 0 0 0 0 
26 25 16 0 0 0 0 0 0 0 0 0 0 0 0 50 26 2 4 26 16 0 0 0 0 0 0 4 26 
25 25 10 0 0 0 0 0 0 0 0 0 4 26 5 4 26 2 1 26 2 0 0 0 50 51 52 1 25 
26 30 51 52 0 0 50 51 52 0 0 0 50 32 2 1 25 8 25 17 25 5 0 0 0 0 0 1 26 
25 16 0 0 0 0 0 0 0 0 0 0 4 25 2 1 25 3 26 3 25 26 5 0 0 0 0 1 26 
26 2 0 0 0 0 0 0 0 0 0 0 1 25 2 1 26 13 26 11 30 51 52 0 0 0 0 1 25 
25 2 0 0 0 0 0 0 0 0 0 0 1 25 2 1 26 2 14 0 14 0 0 0 0 0 9 26 25 
25 2 0 0 0 0 0 0 0 0 0 0 1 25 2 1 25 2 0 0 0 0 0 0 9 25 10 15 25 
26 2 0 0 0 0 0 0 0 0 0 0 1 25 2 1 25 25 26 26 25 30 52 0 0 14 0 1 25
