52
8
5 2 0 0 0 0 0 0 0 0 0 0 0 0 0 0 0 0 0 0 0 0 0 0 0 0 0 0 0 0 0 0 0 0 0 0 0 0 0 0 0 0 0 0 0 0 0 0 0 0 0 0 
28 4 0 0 0 0 0 0 0 0 0 0 0 0 0 0 0 0 0 0 0 0 0 0 0 0 0 0 0 0 0 0 0 0 0 0 0 0 0 0 0 0 0 0 0 0 0 25 47 21 47 47 
28 4 0 0 0 0 0 0 0 0 0 0 0 0 0 0 0 0 0 0 0 0 0 0 0 0 0 14 0 0 0 0 0 0 0 0 0 0 0 0 0 0 0 0 0 0 0 25 47 20 47 21 
28 4 0 0 0 0 0 0 0 0 0 0 0 0 0 0 0 0 0 0 0 0 0 0 0 1 27 2 0 0 0 0 0 0 0 0 0 0 0 0 0 0 0 0 0 0 0 25 47 47 47 47 
28 4 0 29 31 0 0 0 0 0 0 0 0 0 13 0 0 15 16 0 0 0 0 0 0 29 6 4 0 0 0 0 0 0 0 0 0 0 0 0 0 0 0 0 0 0 0 0 23 21 24 23 
5 27 2 0 12 0 0 0 0 0 0 0 0 0 1 27 2 0 0 0 0 1 27 2 0 3 28 4 0 0 0 0 0 0 1 27 2 0 0 0 0 0 0 0 0 0 0 0 25 20 26 25 
28 5 27 27 27 27 27 27 27 27 27 27 27 27 27 7 27 27 27 27 27 27 7 27 27 27 6 4 0 0 0 1 27 27 27 7 27 27 27 27 27 27 27 27 27 27 27 27 32 33 33 33 
28 28 28 28 28 28 28 28 28 28 28 28 28 28 28 28 28 28 28 28 28 28 28 28 28 28 19 0 0 0 0 0 18 28 28 28 28 28 28 28 28 28 28 28 28 28 28 28 28 28 28 28 
